genus1 	Potential_function_simple	function_combined
A17 	non-N 	non-N
Acetivibrio 	Cellulolytic 	Cellulolytic
Acetobacteroides 	Hydrogen-producing 	Hydrogen-producing
Acetogenic 	Acetogenic 	Acetogenic
Achromobacter 	Denitrification-complete	nirK  norB  nosZ
Acidibacter 	Fe3 reduction 	Fe3 reduction
Acidobacteria 	 	C_fix   N_cycle  S_cycle  Fe_Cycle  H2_ox  H2_prod  C1_ox  aerobic
Acidobacterium 	non-N 	non-N
Acidothermus 	Denitrification-nirK	nirK
Acidovorax 	non-N 	non-N
Acinetobacter 	non-N 	non-N
Actinobacillus 	Denitrification-partial	nirK  norB
Actinobacteria 	 	C_fix   N_cycle  S_cycle   H2_ox  H2_prod  C1_ox  aerobic
Actinobacteria_phylum_hgcI clade 	varied 	varied
Actinomyces 	Denitrification-partial	nirK  norB
Actinoplanes 	Denitrification-nirK	nirK
Actinosynnema 	Denitrification-nirK	nirK
Actinotalea 	Cellulolytic+ 	Cellulolytic+
ADurb.Bin063-1 	varied_archaea 	varied_archaea
Aequorivita 	Denitrification-partial	nirK   nosZ
Aerococcus 	non-N 	non-N
Aeroliceae WCHB1-05 	Cellulolytic 	Cellulolytic
Aerolinea 	Cellulolytic 	Cellulolytic
Aeromos 	non-N 	non-N
Aeromyxobacter 	Denitrification 	Denitrification
Aerospora 	non-N 	non-N
Aetherobacter 	non-N 	non-N
Afipia 	Denitrification-complete	nirK  norB  nosZ
Agrobacterium 	non-N 	non-N
Ajellomyces 	Denitrification-partial	nirK  norB
Akkermansia 	non-N 	non-N
Alcaligenes 	Denitrification-complete	nirK  norB  nosZ
Alcanivorax 	Denitrification-complete	nirK  norB  nosZ
Algorimari 	non-N 	non-N
Alicycliphilus 	Denitrification-complete	nirK nirS norB nosZ
Alicyclobacillus 	Denitrification 	Denitrification
Alkalilimnicola 	 	norB nosZ
Alkanibacter 	non-N 	non-N
Alkanindiges 	non-N 	non-N
Allorhizobium-Neorhizobium-Pararhizobium-Rhizobium 	N fixation 	N fixation
Alphaproteobacteria 	 	N_cycle  S_cycle   H2_ox  H2_prod  C1_ox  aerobic
Altererythrobacter 	non-N 	non-N
Ambiguous_taxa 	unclassified 	unclassified
Aquabacterium 	Denitrification 	Denitrification
Aquicella 	non-N 	non-N
archaeon 	 	C_fix    S_cycle   H2_ox  H2_prod   aerobic
Arcobacter 	Denitrification 	Denitrification
Arenimos 	non-N 	non-N
Armatimodetes 	 	C_fix   N_cycle  S_cycle   H2_ox  H2_prod   aerobic
Aromatoleum 	Denitrification-complete	nirS norB  nosZ
Arthrobacter 	Nitrite oxidation 	Nitrite oxidation
Arthroderma 	Denitrification-partial	nirK  norB
Aspergillus 	Denitrification-partial	nirK  norB
Atopobium 	Denitrification-nirK	nirK
Aurantimicrobium 	non-N 	non-N
Austwickia 	Denitrification-partial	nirK  norB
Avibacterium 	Denitrification-nirK	nirK
Azoarcus 	N fixation 	N fixation
Azospirillium 	Denitrification-partial	nirS  nosZ
Azospirillum 	N fixation 	N fixation
Azovibrio 	 	norB
Bacillus 	Denitrification 	Denitrification
Bacteriovorax 	non-N 	non-N
Bacteroides 	non-N 	non-N
Bacteroidetes 	 	N_fix  N_cycle  S_cycle  Fe_Cycle  H2_ox  H2_prod  C1_ox  aerobic
Bauldia 	non-N 	non-N
Bdellovibrio 	non-N 	non-N
Bdellovibrioles 	 	C_fix  N_fix  N_cycle  S_cycle  Fe_Cycle  H2_ox  H2_prod  C1_ox  aerobic
Belliella 	Denitrification-partial	nirK   nosZ
Betaproteobacteria 	 	C_fix   N_cycle  S_cycle  Fe_Cycle  H2_ox  H2_prod  C1_ox  aerobic
Bifidobacterium 	non-N 	non-N
Bizionia 	Denitrification-complete	nirK  norB  nosZ
Blastocatellaceae_family_JGI 0001001-H03 	varied 	varied
Blastococcus 	Denitrification-nirK	nirK
Blautia 	Denitrification 	Denitrification
Blvii28 	non-N 	non-N
Bordetella 	Denitrification-complete	nirS norB  nosZ
Bosea 	Thiosulfate oxidation 	Thiosulfate oxidation
Brachybacterium 	Denitrification-partial	nirK  norB
Bradyrhizobium 	N fixation 	N fixation
Brevundimos 	Denitrification-nirK	nirK
Brucella 	Denitrification-complete	nirK  norB nosZ
Bryobacter 	non-N 	non-N
Burkholderia 	non-N 	non-N
Burkholderiales 	Denitrification-partial	"nirS norB ,  C_fix  N_fix  N_cycle  S_cycle  Fe_Cycle  H2_ox  H2_prod  C1_ox  aerobic"
Butyrivibrio 	Cellulolytic 	Cellulolytic
C39 	non-N 	non-N
Caldaerobacter 	Cellulolytic 	Cellulolytic
Caldalkalibacillus 	Denitrification-nirK	nirK
Caldicellulosiruptor 	Cellulolytic 	Cellulolytic
Caldilinea 	 	nosZ
Caldithrix 	 	H2_ox  H2_prod   aerobic
Caldivirga 	Denitrification-partial	nirK  norB
Campylobacter 	 	norB nosZ
candidate division CPR2 	 	S_cycle   H2_ox  H2_prod   aerobic
candidate division CPR3 	 	aerobic
candidate division Kaza 	 	aerobic
candidate division KSB1 	 	H2_ox  H2_prod   aerobic
candidate division NC1 	 	N_cycle   Fe_Cycle    C1_ox  aerobic
candidate division TM6 	 	aerobic
candidate division WOR-1 	 	S_cycle   H2_ox  H2_prod  C1_ox  aerobic
candidate division WOR-3 	 	H2_ox    aerobic
candidate division WS6 	 	S_cycle      aerobic
candidate division WWE3 	 	S_cycle   H2_ox  H2_prod   aerobic
candidate division Zixibacteria 	 	N_fix  N_cycle  S_cycle  Fe_Cycle  H2_ox  H2_prod   aerobic
Candidatus Abawacabacteria 	 	aerobic
Candidatus Accumulibacter 	Polyphosphate-accumulating 	Polyphosphate-accumulating
Candidatus Adlerbacteria 	 	aerobic
Candidatus Amesbacteria 	 	S_cycle      aerobic
Candidatus Aminicentes 	 	C_fix   N_cycle  S_cycle  Fe_Cycle  H2_ox  H2_prod   aerobic
Candidatus Andersenbacteria 	 	S_cycle   H2_ox  H2_prod   aerobic
Candidatus Atribacteria 	 	H2_prod  C1_ox  aerobic
Candidatus Azambacteria 	 	N_cycle  S_cycle   H2_ox  H2_prod   aerobic
Candidatus babela 	non-N 	non-N
Candidatus Babela 	non-N 	non-N
Candidatus Bathyarchaeota 	 	C_fix    S_cycle  Fe_Cycle  H2_ox  H2_prod  C1_ox  aerobic
Candidatus Beckwithbacteria 	 	S_cycle   H2_ox  H2_prod   aerobic
Candidatus Berkelbacteria 	 	S_cycle   H2_ox  H2_prod   aerobic
Candidatus Blackburnbacteria 	 	aerobic
Candidatus Brennerbacteria 	 	aerobic
Candidatus brocadia 	Ammox 	Ammox
Candidatus Brocadia 	Ammox 	Ammox
Candidatus Buchanbacteria 	 	S_cycle   H2_ox  H2_prod   aerobic
Candidatus Campbellbacteria 	 	S_cycle      aerobic
Candidatus Chisholmbacteria 	 	S_cycle   H2_ox  H2_prod   aerobic
Candidatus Coatesbacteria 	 	H2_ox    aerobic
Candidatus Collierbacteria 	 	C_fix  N_fix   S_cycle   H2_ox  H2_prod  C1_ox  aerobic
Candidatus Colwellbacteria 	 	aerobic
Candidatus Curtissbacteria 	 	S_cycle   H2_ox  H2_prod   aerobic
Candidatus Dadabacteria 	 	N_cycle  S_cycle  Fe_Cycle   H2_prod   aerobic
Candidatus Daviesbacteria 	 	N_fix        aerobic
Candidatus Delongbacteria 	 	H2_prod   aerobic
Candidatus Diapherotrites_phylum 	varied_archaea 	varied_archaea
Candidatus Doudbacteria 	 	N_cycle       aerobic
Candidatus Edwardsbacteria 	 	H2_ox  H2_prod   aerobic
Candidatus Eisenbacteria 	 	N_cycle  S_cycle  Fe_Cycle   H2_prod  C1_ox  aerobic
Candidatus Falkowbacteria 	 	C_fix    S_cycle   H2_ox  H2_prod   aerobic
Candidatus Firestonebacteria 	 	S_cycle   H2_ox  H2_prod   aerobic
Candidatus Fischerbacteria 	 	S_cycle  Fe_Cycle  H2_ox  H2_prod  C1_ox  aerobic
Candidatus Fraserbacteria 	 	C_fix   N_cycle  S_cycle   H2_ox  H2_prod   aerobic
Candidatus Giovannonibacteria 	 	S_cycle   H2_ox  H2_prod   aerobic
Candidatus Glassbacteria 	 	N_cycle  S_cycle   H2_ox  H2_prod  C1_ox  aerobic
Candidatus Gottesmanbacteria 	 	S_cycle   H2_ox  H2_prod   aerobic
Candidatus Handelsmanbacteria 	 	N_cycle  S_cycle  Fe_Cycle  H2_ox  H2_prod  C1_ox  aerobic
Candidatus Harrisonbacteria 	 	aerobic
Candidatus Jacksonbacteria 	 	S_cycle   H2_ox  H2_prod   aerobic
Candidatus jettenia 	Ammox 	Ammox
Candidatus Jettenia 	Ammox 	Ammox
Candidatus Jorgensenbacteria 	 	S_cycle   H2_ox  H2_prod   aerobic
Candidatus Kaiserbacteria 	 	N_fix  N_cycle  S_cycle    H2_prod   aerobic
Candidatus Kerfeldbacteria 	 	S_cycle   H2_ox  H2_prod   aerobic
Candidatus Komeilibacteria 	 	S_cycle   H2_ox  H2_prod   aerobic
Candidatus koribacter 	Denitrification+ 	Denitrification+
Candidatus Kuenenbacteria 	 	C_fix       H2_prod   aerobic
Candidatus kuenenia 	Ammox 	Ammox
Candidatus Kuenenia 	Ammox 	Ammox
Candidatus Lambdaproteobacteria 	 	N_cycle  S_cycle   H2_ox    aerobic
Candidatus Levybacteria 	 	C_fix    S_cycle   H2_ox  H2_prod   aerobic
Candidatus Lindowbacteria 	 	N_cycle  S_cycle  Fe_Cycle  H2_ox  H2_prod   aerobic
Candidatus Liptonbacteria 	 	N_cycle       aerobic
Candidatus Lloydbacteria 	 	N_cycle  S_cycle   H2_ox  H2_prod   aerobic
Candidatus Magasanikbacteria 	 	N_fix  N_cycle  S_cycle   H2_ox  H2_prod   aerobic
Candidatus Magasanikbacteria bacterium RIFCSPHIGHO2_02_FULL_50_9b 	CPR-OD1 	CPR-OD1
Candidatus Margulisbacteria 	 	S_cycle   H2_ox  H2_prod  C1_ox  aerobic
Candidatus Melaibacteria 	 	N_cycle  S_cycle    H2_prod   aerobic
Candidatus metachlamydia 	non-N 	non-N
Candidatus Metachlamydia 	non-N 	non-N
Candidatus Methylomirabilis 	Denitrification-partial	nirS norB
Candidatus Micrarchaeota 	 	C_fix    S_cycle   H2_ox  H2_prod   aerobic
Candidatus Microthrix 	Denitrification-nirK	nirK
Candidatus Moranbacteria 	 	S_cycle   H2_ox  H2_prod   aerobic
Candidatus Muproteobacteria 	 	C_fix   N_cycle  S_cycle  Fe_Cycle  H2_ox  H2_prod  C1_ox  aerobic
Candidatus Nealsonbacteria 	 	H2_prod   aerobic
Candidatus nitrosoarchaeum 	Ammonia oxidation 	Ammonia oxidation
Candidatus Nitrosoarchaeum 	Ammonia oxidation 	Ammonia oxidation
Candidatus nitrosocaldus 	Ammonia oxidation 	Ammonia oxidation
Candidatus Nitrosocaldus 	Ammonia oxidation 	Ammonia oxidation
Candidatus Nitrosopumilus 	Denitrification-nirK	nirK
Candidatus nitrososphaera 	Ammonia oxidation 	Ammonia oxidation
Candidatus Nitrososphaera 	Ammonia oxidation 	Ammonia oxidation
Candidatus nitrosotalea 	Ammonia oxidation 	Ammonia oxidation
Candidatus Nitrosotalea 	Ammonia oxidation 	Ammonia oxidation
Candidatus Nitrosotenuis 	Ammonia oxidation 	Ammonia oxidation
Candidatus Nitrospira 	Denitrification-nirK	nirK
Candidatus nitrotoga 	Nitrite oxidation 	Nitrite oxidation
Candidatus Nitrotoga 	Nitrite oxidation 	Nitrite oxidation
Candidatus Niyogibacteria 	 	N_cycle  S_cycle      aerobic
Candidatus Nomurabacteria 	 	N_fix  N_cycle  S_cycle    H2_prod   aerobic
Candidatus Omnitrophus 	Magnetatactic+ 	Magnetatactic+
Candidatus Pacearchaeota 	 	C_fix  N_fix   S_cycle   H2_ox  H2_prod   aerobic
Candidatus Pacearchaeota_phylum 	varied_archaea 	varied_archaea
Candidatus Pacebacteria 	 	aerobic
Candidatus Peregrinibacteria 	 	C_fix  N_fix   S_cycle    H2_prod   aerobic
Candidatus Peribacteria 	 	N_cycle      C1_ox  aerobic
Candidatus phytoplasma 	non-N 	non-N
Candidatus Phytoplasma 	non-N 	non-N
Candidatus planktophila 	non-N 	non-N
Candidatus Planktophila 	non-N 	non-N
Candidatus Portnoybacteria 	 	S_cycle   H2_ox  H2_prod   aerobic
Candidatus protistobacter 	non-N 	non-N
Candidatus Protistobacter 	non-N 	non-N
Candidatus protochlamydia 	non-N 	non-N
Candidatus Protochlamydia 	non-N 	non-N
Candidatus rhabdochlamydia 	non-N 	non-N
Candidatus Rhabdochlamydia 	non-N 	non-N
Candidatus Riflebacteria 	 	C_fix    S_cycle    H2_prod  C1_ox  aerobic
Candidatus Roizmanbacteria 	 	S_cycle   H2_ox  H2_prod   aerobic
Candidatus Rokubacteria 	 	N_fix  N_cycle  S_cycle  Fe_Cycle   H2_prod  C1_ox  aerobic
Candidatus Ryanbacteria 	 	N_cycle  S_cycle    H2_prod   aerobic
Candidatus Saccharibacteria 	 	N_cycle       aerobic
Candidatus saccharimos 	Denitrification 	Denitrification
Candidatus Saccharimos 	Denitrification 	Denitrification
Candidatus Schekmanbacteria 	 	N_cycle  S_cycle  Fe_Cycle   H2_prod  C1_ox  aerobic
Candidatus Shapirobacteria 	 	aerobic
Candidatus solibacter 	Denitrification+ 	Denitrification+
Candidatus Spechtbacteria 	 	N_cycle       aerobic
Candidatus Staskawiczbacteria 	 	H2_prod   aerobic
Candidatus Sungbacteria 	 	N_fix  N_cycle  S_cycle   H2_ox  H2_prod   aerobic
Candidatus Tagabacteria 	 	S_cycle   H2_ox  H2_prod   aerobic
Candidatus Taylorbacteria 	 	H2_prod   aerobic
Candidatus Tectomicrobia 	 	N_cycle  S_cycle  Fe_Cycle    C1_ox  aerobic
Candidatus Terrybacteria 	 	N_cycle       aerobic
Candidatus Uhrbacteria 	 	N_cycle  S_cycle   H2_ox  H2_prod   aerobic
Candidatus Veblenbacteria 	 	S_cycle   H2_ox  H2_prod   aerobic
Candidatus vidania 	non-N 	non-N
Candidatus Vidania 	non-N 	non-N
Candidatus Vogelbacteria 	 	S_cycle      aerobic
Candidatus Wallbacteria 	 	N_cycle     H2_prod   aerobic
Candidatus Wildermuthbacteria 	 	H2_prod   aerobic
Candidatus Woesearchaeota 	 	S_cycle   H2_ox  H2_prod   aerobic
Candidatus Woesebacteria 	 	S_cycle      aerobic
Candidatus Wolfebacteria 	 	N_cycle  S_cycle      aerobic
Candidatus Woykebacteria 	 	S_cycle   H2_ox  H2_prod   aerobic
Candidatus Yanofskybacteria 	 	N_cycle  S_cycle   H2_ox  H2_prod  C1_ox  aerobic
Candidatus Yothbacteria 	 	N_cycle       aerobic
Candidatus Zambryskibacteria 	 	N_cycle  S_cycle      aerobic
Candidatus_brocadia 	Ammox 	Ammox
Candidatus_Brocadia 	Ammox 	Ammox
Candidatus_Koribacter 	Denitrification+ 	Denitrification+
Candidatus_methanoregula 	Methanogen 	Methanogen
Candidatus_Methanoregula 	Methanogen 	Methanogen
Candidatus_Nitrosocosmicus 	Ammonia oxidation 	Ammonia oxidation
Candidatus_nitrososphaera 	Ammonia oxidation 	Ammonia oxidation
Candidatus_Nitrososphaera 	Ammonia oxidation 	Ammonia oxidation
Candidatus_protochlamydia 	non-N 	non-N
Candidatus_Protochlamydia 	non-N 	non-N
Candidatus_rhabdochlamydia 	non-N 	non-N
Candidatus_Rhabdochlamydia 	non-N 	non-N
Candidatus_Solibacter 	Denitrification+ 	Denitrification+
Candidatus_xiphinematobacter 	non-N 	non-N
Candidatus_Xiphinematobacter 	non-N 	non-N
Capnocytophaga 	Denitrification-complete	nirK  norB  nosZ
Cardiobacterium 	Denitrification-complete	nirK  norB  nosZ
Caulobacter 	non-N 	non-N
Caulobacterales 	 	N_cycle  S_cycle     C1_ox  aerobic
Cecembia 	Denitrification-complete	nirK  norB  nosZ
Celeribacter 	Denitrification-complete	nirK  norB  nosZ
Cellulomos 	Cellulolytic+ 	Cellulolytic+
Cellulophaga 	 	norB  nosZ
Cellvibrio 	Denitrification-nirK	nirK
Cerchaeum 	Ammonia oxidation 	Ammonia oxidation
Chaetomium 	Denitrification-partial	nirK  norB
Chelatococcus 	Denitrification-complete	nirK  norB  nosZ
Chitinophaga 	non-N 	non-N
Chlamydia 	non-N 	non-N
Chlamydiae 	 	S_cycle   H2_ox  H2_prod   aerobic
Chloroflexi 	 	C_fix  N_fix  N_cycle  S_cycle  Fe_Cycle  H2_ox  H2_prod  C1_ox  aerobic
Chloroflexus 	Denitrification-nirK	nirK
Chromatiales 	 	S_cycle     C1_ox  aerobic
Chromobacterium 	Denitrification-partial	nirK  norB
Chryseobacterium 	Denitrification-partial	nirK  norB
Chthoniobacter 	non-N 	non-N
Citreicella 	 	nosZ
Cloacibacterium 	non-N 	non-N
Clostridiales 	 	N_fix   S_cycle   H2_ox  H2_prod  C1_ox  aerobic
Clostridium 	Cellulolytic 	Cellulolytic
Coccidioides 	Denitrification-nirK	nirK
Colwellia 	Denitrification-complete	nirS norB nosZ
Comamos 	Denitrification-nirS	nirS
Compostimos 	Denitrification 	Denitrification
Conexibacter 	Denitrification 	Denitrification
Coprococcus 	non-N 	non-N
Corynebacterium 	non-N 	non-N
Coxiella 	non-N 	non-N
Crenothrix 	Methanogen 	Methanogen
Crocinitomix 	non-N 	non-N
Cupriavidus 	non-N 	non-N
Curtobacterium 	non-N 	non-N
Curvibacter 	 	C_fix   N_cycle  S_cycle    H2_prod  C1_ox  aerobic
Cytophaga 	non-N 	non-N
Dechloromos 	Denitrification 	Denitrification
Dechlorosoma 	Denitrification-complete	nirS norB  nosZ
Delftia 	non-N 	non-N
Deltaproteobacteria 	 	C_fix  N_fix  N_cycle  S_cycle  Fe_Cycle  H2_ox  H2_prod  C1_ox  aerobic
Demequi 	non-N 	non-N
Denitratisoma 	non-N 	non-N
Denitrification 	Denitrification 	Denitrification
Denitrobacterium 	Denitrification 	Denitrification
Denitrovibrio 	 	nosZ
Desulfitobacterium 	 	norB nosZ
Desulfobacca 	 	N_cycle  S_cycle   H2_ox  H2_prod  C1_ox  aerobic
Desulfobacterales 	 	C_fix   N_cycle  S_cycle  Fe_Cycle  H2_ox  H2_prod  C1_ox  aerobic
Desulfobacula 	 	C_fix    S_cycle   H2_ox  H2_prod  C1_ox  aerobic
Desulfobulbus 	non-N 	non-N
Desulfomonile 	 	norB  nosZ
Desulfosporosinus 	Sulfur reduction 	Sulfur reduction
Desulfotomaculum 	 	nosZ
Desulfovibrio 	Denitrification 	Denitrification
Desulfovibrioles 	 	N_cycle  S_cycle   H2_ox  H2_prod   aerobic
Desulfuromodales 	 	N_fix  N_cycle   Fe_Cycle  H2_ox  H2_prod  C1_ox  aerobic
Devosia 	Denitrification 	Denitrification
Dialister 	non-N 	non-N
Diaphorobacter 	Denitrification-partial	nirK  norB
Dietzia 	Denitrification-nirK	nirK
Dinghuibacter 	non-N 	non-N
Dinoroseobacter 	Denitrification-complete	nirS norB nosZ
Dokdonella 	Denitrification 	Denitrification
Dongia 	Denitrification 	Denitrification
Duganella 	non-N 	non-N
Dyadobacter 	 	nosZ
Dyella 	Denitrification 	Denitrification
Ellin6067 	Ammonia oxidation 	Ammonia oxidation
Elusimicrobia 	 	C_fix  N_fix  N_cycle  S_cycle  Fe_Cycle  H2_ox  H2_prod  C1_ox  aerobic
endosymbiont 	Denitrification-complete	nirS norB  nosZ
Ensifer 	Denitrification-partial	nirK  norB
Enterococcus 	Denitrification-partial	nirK  norB
Erythrobacter 	 	N_cycle  S_cycle     C1_ox  aerobic
Ethanoligenens 	non-N 	non-N
Eubacterium 	Cellulolytic 	Cellulolytic
Euryarchaeota 	 	C_fix  N_fix  N_cycle  S_cycle   H2_ox  H2_prod  C1_ox  aerobic
Faecalibacterium 	non-N 	non-N
family_Candidatus Diapherotrites archaeon_ADurb.Bin063-1 	varied_archaea 	varied_archaea
family_Microscillaceae_OLB12 	varied 	varied
family_Nitrosomodaceae_IS-44 	Ammonia oxidation 	Ammonia oxidation
Ferribacterium 	Denitrification 	Denitrification
Ferritrophicum 	Fe2 oxidation 	Fe2 oxidation
Ferroglobus 	 	norB  nosZ
Ferruginibacter 	non-N 	non-N
Fimbriimos 	non-N 	non-N
Firmicutes 	 	H2_prod   aerobic
Flavisolibacter 	non-N 	non-N
Flavobacteria 	 	N_cycle  S_cycle   H2_ox  H2_prod  C1_ox  aerobic
Flavobacteriaceae 	Denitrification-partial	nirK   nosZ
Flavobacteriales 	Denitrification-complete	nirK  norB nosZ
Flavobacterium 	non-N 	non-N
Flexibacter 	Denitrification-complete	nirK  norB  nosZ
Fluviicola 	 	aerobic
Fusarium 	Denitrification-partial	nirK  norB
g__Wchb1-05_f__Aerolineacaea 	varied 	varied
Gaiella 	Denitrification 	Denitrification
Galbibacter 	Denitrification-partial	nirK  norB
Gallibacterium 	Denitrification-partial	nirK  norB
Gallionella 	Nitric oxide reduction 	Nitric oxide reduction
Gallionellales 	 	C_fix  N_fix  N_cycle  S_cycle  Fe_Cycle  H2_ox  H2_prod   aerobic
gamma 	Denitrification-complete	nirK nirS norB  nosZ
Gammaproteobacteria 	 	C_fix   N_cycle  S_cycle  Fe_Cycle  H2_ox  H2_prod  C1_ox  aerobic
Gemmata 	varied 	varied
Gemmatimodetes 	 	N_cycle  S_cycle   H2_ox  H2_prod  C1_ox  aerobic
Gemmatimos 	non-N 	non-N
Geobacillus 	Denitrification-complete	nirK  norB nosZ
Geobacter 	non-N 	non-N
Geobacteraceae 	 	N_fix  N_cycle  S_cycle  Fe_Cycle  H2_ox  H2_prod  C1_ox  aerobic
Georgfuchsia 	Denitrification 	Denitrification
Geothrix 	Denitrification 	Denitrification
Gibberella 	Denitrification-partial	nirK  norB
Giesbergeria 	non-N 	non-N
Gillisia 	Denitrification-partial	nirK   nosZ
Glaciecola 	Denitrification-partial	nirK  norB
Glomus 	non-N 	non-N
Gouta19 	Sulfur reduction 	Sulfur reduction
GOUTA19 	Sulfur reduction 	Sulfur reduction
Gramella 	 	nosZ
Haemophilus 	Denitrification-partial	nirK  norB
Hahella 	Denitrification-complete	nirS norB nosZ
Haliangium 	non-N 	non-N
Haliscomenobacter 	 	norB  nosZ
Haloarcula 	Denitrification-complete	nirK  norB nosZ
Halobacterium 	 	nosZ
Halocella 	Cellulolytic 	Cellulolytic
Haloferax 	Denitrification-complete	nirK  norB  nosZ
Halogeometricum 	Denitrification-complete	nirK  norB  nosZ
Halomicrobium 	Denitrification-partial	nirK  norB
Halomos 	Denitrification 	Denitrification
halophilic 	 	nosZ
Halopiger 	Denitrification-complete	nirK  norB  nosZ
Halorhabdus 	Denitrification-nirK	nirK
Halorubrum 	 	norB  nosZ
Haloterrige 	Denitrification-partial	nirK  norB
Herbaspirillum 	Denitrification 	Denitrification
Herminiimos 	non-N 	non-N
Herpetosiphon 	Denitrification-nirK	nirK
heteroC45_4W 	non-N 	non-N
Heteroc45_4W 	non-N 	non-N
hgcI clade 	varied 	varied
Histoplasma 	Denitrification-partial	nirK  norB
Holophaga 	non-N 	non-N
Hydrogenobacter 	Denitrification-complete	nirS norB nosZ
Hydrogenophaga 	Denitrification 	Denitrification
Hydrogenophilales 	 	C_fix   N_cycle  S_cycle   H2_ox  H2_prod  C1_ox  aerobic
Hymenobacter 	non-N 	non-N
Hyphomicrobium 	Denitrification 	Denitrification
Hyphomodaceae_family_SWB02 	varied 	varied
Ideonella 	non-N 	non-N
Idiomari 	Denitrification-partial	nirK  norB
Igvibacteria 	 	N_cycle  S_cycle   H2_ox  H2_prod  C1_ox  aerobic
Igvibacterium 	Sulfur reduction 	Sulfur reduction
Imtechella 	Denitrification-complete	nirK  norB  nosZ
Incisomos 	non-N 	non-N
Indibacter 	Denitrification-partial	nirK  norB
Intrasporangium 	Denitrification-partial	nirK  norB
IS-44 	Ammonia oxidation 	Ammonia oxidation
Janthinobacterium 	non-N 	non-N
JGI 0001001-H03 	varied 	varied
JGI 0001001-H03 	varied 	varied
Jonesia 	Denitrification-nirK	nirK
Kaistia 	Denitrification 	Denitrification
Kaistobacter 	non-N 	non-N
Kangiella 	Denitrification-partial	nirK nirS norB
Kineosphaera 	Denitrification-partial	nirK  norB
Kingella 	Denitrification-complete	nirK  norB  nosZ
Knoellia 	Denitrification 	Denitrification
Kuenenia 	Ammox 	Ammox
Labrenzia 	Denitrification-complete	nirS norB  nosZ
Lacunisphaera 	non-N 	non-N
Lautropia 	Denitrification-complete	nirK  norB  nosZ
Legionella 	non-N 	non-N
Legionellales 	 	S_cycle   H2_ox  H2_prod   aerobic
Lentisphaerae 	 	C_fix  N_fix  N_cycle  S_cycle   H2_ox  H2_prod  C1_ox  aerobic
Leptolinea 	non-N 	non-N
Leptolyngbya 	N fixation 	N fixation
Leptonema 	non-N 	non-N
Leptospira 	non-N 	non-N
Leptothrix 	Denitrification-complete	nirS norB  nosZ
Leptotrichia 	non-N 	non-N
Levilinea 	non-N 	non-N
Limnobacter 	Sulfur oxidation 	Sulfur oxidation
Luteimos 	Denitrification 	Denitrification
Luteolibacter 	non-N 	non-N
Lutiella 	Denitrification-complete	nirS norB  nosZ
Lysobacter 	Degrade chitin 	Degrade chitin
Macellibacteroides 	non-N 	non-N
Magnetococcus 	 	norB
Magnetospirillum 	non-N 	non-N
Malikia 	Denitrification 	Denitrification
Mannheimia 	Denitrification-partial	nirK  norB
Maribacter 	Denitrification-complete	nirK  norB  nosZ
Marine 	Denitrification-nirK	nirK
Marinilabilia 	Denitrification-complete	nirK  norB  nosZ
Marinobacter 	Denitrification-complete	nirK nirS norB nosZ
Maritimibacter 	Denitrification-complete	nirK  norB  nosZ
Massilia 	Denitrification 	Denitrification
Megasphaera 	non-N 	non-N
Melioribacter 	 	nosZ
Mesorhizobium 	N fixation 	N fixation
metagenome 	unclassified 	unclassified
Methanobacterium 	non-N 	non-N
Methanobrevibacter 	Methanogen 	Methanogen
Methanomassiliicoccus 	Methanogen 	Methanogen
Methanosaeta 	non-N 	non-N
Methanosarci 	Methanogen 	Methanogen
Methanospirillum 	Methanogen 	Methanogen
Methylacidiphilum 	Denitrification-partial	nirK  norB
Methylobacter 	Methanotroph 	Methanotroph
Methylobacterium 	non-N 	non-N
Methylocella 	Denitrification-partial	nirK  norB
Methylococcaceae 	Methanotroph 	Methanotroph
Methylococcus 	 	norB
Methylocystis 	non-N 	non-N
Methylomos 	Methanotroph 	Methanotroph
Methylophaga 	non-N 	non-N
Methylophilales 	 	N_cycle  S_cycle     C1_ox  aerobic
Methylosarci 	non-N 	non-N
Methylosinus 	Denitrification 	Denitrification
Methylotenera 	non-N 	non-N
Methylothermus 	Denitrification 	Denitrification
Methyloversatilis 	non-N 	non-N
Methylovulum 	Methanotroph 	Methanotroph
Microgenomates group 	 	S_cycle   H2_ox  H2_prod   aerobic
Microlutus 	Denitrification-partial	nirK  norB
Micromonospora 	non-N 	non-N
Mobilicoccus 	Denitrification-partial	nirK  norB
Moraxella 	Denitrification-partial	nirK  norB
Moritella 	 	nosZ
Mucilaginibacter 	non-N 	non-N
Muricauda 	Denitrification-complete	nirK  norB  nosZ
Mycobacterium 	non-N 	non-N
Mycoplasma 	non-N 	non-N
Myroides 	Denitrification-complete	nirK  norB  nosZ
Neisseria 	Denitrification-complete	nirK  norB nosZ
Neochlamydia 	obligate parasite 	obligate parasite
Neosartorya 	Denitrification-nirK	nirK
Nevskia 	non-N 	non-N
Niabella 	non-N 	non-N
Niastella 	 	nosZ
Nisaea 	Denitrification-partial	nirK   nosZ
Nitratifractor 	Denitrification 	Denitrification
Nitratireductor 	Denitrification 	Denitrification
Nitratiruptor 	Denitrification 	Denitrification
Nitrobacter 	Nitrite oxidation 	Nitrite oxidation
Nitrosococcus 	Nitrite oxidation 	Nitrite oxidation
Nitrosocosmicus 	Ammonia oxidation 	Ammonia oxidation
Nitrosomodaceae_family_Ellin6067 	Ammonia oxidation 	Ammonia oxidation
Nitrosomodaceae_family_GOUTA6 	Ammonia oxidation 	Ammonia oxidation
Nitrosomodaceae_family_MND1 	Ammonia oxidation 	Ammonia oxidation
Nitrosomos 	Ammonia oxidation 	Ammonia oxidation
Nitrosopumilus 	Ammonia oxidation 	Ammonia oxidation
Nitrososphaera 	Ammonia oxidation 	Ammonia oxidation
Nitrosospira 	Ammonia oxidation 	Ammonia oxidation
Nitrosovibrio 	Ammonia oxidation 	Ammonia oxidation
Nitrospi 	Nitrite oxidation 	Nitrite oxidation
Nitrospie 	 	C_fix   N_cycle  S_cycle  Fe_Cycle  H2_ox  H2_prod   aerobic
Nitrospira 	Nitrite oxidation 	Nitrite oxidation
Nitrospirae 	 	C_fix  N_fix  N_cycle  S_cycle  Fe_Cycle  H2_ox  H2_prod  C1_ox  aerobic
Nitrospirillum 	N fixation 	N fixation
Nocardia 	Denitrification-partial	nirK  norB
Nocardioides 	Denitrification-nirK	nirK
non-N 	non-N 	non-N
non-N 	non-N 	non-N
Novosphingobium 	non-N 	non-N
Oceanimos 	Denitrification-partial	nirK  norB
Oceaniovalibus 	Denitrification-complete	nirK  norB  nosZ
Oceanithermus 	Denitrification-partial	nirS norB
Ochrobactrum 	Denitrification-complete	nirK  norB nosZ
Octadecabacter 	Denitrification-nirK	nirK
Oligotropha 	Denitrification-partial	nirK   nosZ
Omnitrophica 	 	C_fix  N_fix  N_cycle  S_cycle   H2_ox  H2_prod  C1_ox  aerobic
Omnitrophica WOR_2 	 	C_fix   N_cycle  S_cycle   H2_ox  H2_prod  C1_ox  aerobic
Opitutaceae 	 	nosZ
Opitutus 	Denitrification 	Denitrification
Or-59 	non-N 	non-N
OR-59 	non-N 	non-N
Owenweeksia 	 	nosZ
Paenibacillus 	N fixation 	N fixation
Pajaroellobacter 	obligate parasite 	obligate parasite
Paludibacter 	non-N 	non-N
Paludibaculum 	Fe3 reduction 	Fe3 reduction
Paracoccidioides 	Denitrification-partial	nirK  norB
Paracoccus 	Denitrification-complete	nirK nirS norB nosZ
Parascardovia 	Denitrification-nirK	nirK
Parcubacteria group 	 	N_cycle       aerobic
Parcubacteria_family_Candidatus Magasanikbacteria bacterium RIFCSPHIGHO2_02_FULL_50_9b 	OD-1 	OD-1
Parvibaculum 	Oxidize surfactants 	Oxidize surfactants
Pasteurella 	Denitrification-nirK	nirK
Pedobacter 	non-N 	non-N
Pedomicrobium 	Denitrification 	Denitrification
Pedosphaera 	non-N 	non-N
Pelagicoccus 	OD-1? 	OD-1?
Pelobacter 	non-N 	non-N
Pelobacteraceae 	 	N_cycle    H2_ox  H2_prod   aerobic
Pelosinus 	non-N 	non-N
Pelotomaculum 	non-N 	non-N
Penicillium 	Denitrification-nirK	nirK
Peredibacter 	non-N 	non-N
Perlucidibaca 	Denitrification 	Denitrification
Persephonella 	Denitrification-complete	nirS norB  nosZ
Phaeobacter 	Denitrification-complete	nirK  norB  nosZ
Phascolarctobacterium 	non-N 	non-N
Phenylobacterium 	non-N 	non-N
Phocaeicola 	 	nosZ
Photobacterium 	 	norB nosZ
Phycisphaeraceae_family_SM1A02 	Denitrification 	Denitrification
Pilimelia 	non-N 	non-N
Planctomyces 	Ammox 	Ammox
planctomycete 	Denitrification-nirK	nirK
Planctomycetes 	 	C_fix  N_fix  N_cycle  S_cycle   H2_ox  H2_prod  C1_ox  aerobic
Polaromos 	non-N 	non-N
Polymorphum 	Denitrification-complete	nirS norB  nosZ
Polynucleobacter 	non-N 	non-N
Pontibacter 	Denitrification-complete	nirK  norB  nosZ
Prevotella 	 	nosZ
Prochlorococcus 	OD-1? 	OD-1?
Prolixibacter 	non-N 	non-N
Prolixibacteraceae_family 	N fixation 	N fixation
Prolixibacteraceae_family_BSV13 	N fixation 	N fixation
Propionbacterium 	 	norB
Propionibacterium 	Denitrification-partial	nirK  norB
Propionivibrio 	Denitrification 	Denitrification
Prosthecobacter 	non-N 	non-N
Pseudarthrobacter 	Denitrification 	Denitrification
Pseudoalteromos 	Denitrification-partial	nirK  norB
Pseudogulbenkiania 	Denitrification-complete	nirS norB  nosZ
Pseudolabrys 	non-N 	non-N
Pseudomodales 	 	N_fix  N_cycle  S_cycle   H2_ox  H2_prod  C1_ox  aerobic
Pseudomos 	Denitrification 	Denitrification
Pseudorhodobacter 	non-N 	non-N
Pseudovibrio 	Denitrification-complete	nirS norB  nosZ
Pseudoxanthomos 	Denitrification-partial	nirK  norB
Psychrobacter 	Denitrification-partial	nirK  norB
Psychroflexus 	 	nosZ
Psychromos 	 	nosZ
Pusillimos 	Denitrification-partial	nirK  norB
Pyrobaculum 	Denitrification-complete	nirS norB nosZ
Ralstonia 	Denitrification 	Denitrification
Ralstonia 	Denitrification 	Denitrification
Reinekea 	 	nosZ
Reyranella 	Denitrification 	Denitrification
Rhizobium 	N fixation 	N fixation
Rhodanobacter 	Denitrification 	Denitrification
Rhodobacter 	N fixation 	N fixation
Rhodobacteraceae 	 	C_fix   N_cycle  S_cycle   H2_ox   C1_ox  aerobic
Rhodobacterales 	Denitrification-complete	"nirK  norB  nosZ ,  N_cycle  S_cycle     C1_ox  aerobic"
Rhodococcus 	non-N 	non-N
Rhodocyclaceae dok59 	Denitrification 	Denitrification
Rhodocyclaceae Dok59 	Denitrification 	Denitrification
Rhodocyclales 	 	C_fix   N_cycle  S_cycle  Fe_Cycle  H2_ox  H2_prod  C1_ox  aerobic
Rhodocyclus 	non-N 	non-N
Rhodoferax 	Denitrification 	Denitrification
Rhodomicrobium 	non-N 	non-N
Rhodoplanes 	Denitrification 	Denitrification
Rhodopseudomos 	N fixation+ 	N fixation+
Rhodospirillales 	 	C_fix   N_cycle  S_cycle   H2_ox  H2_prod   aerobic
Rhodospirillum 	 	norB  nosZ
Rhodothermus 	Denitrification-complete	nirK nirS  nosZ
Rhodovulum 	Denitrification-nirK	nirK
Rickettsia 	non-N 	non-N
Riemerella 	 	nosZ
Rikenellaceae_family_Bact-08 	non-N 	non-N
Robiginitalea 	 	nosZ
Romboutsia 	Acetogenic 	Acetogenic
Roseburia 	non-N 	non-N
Roseibium 	Denitrification-nirK	nirK
Roseiflexus 	Denitrification-nirS	nirS
Roseimarinus 	non-N 	non-N
Roseobacter 	Denitrification-complete	nirK nirS norB nosZ
Roseomos 	Denitrification 	Denitrification
Roseovarius 	Denitrification-complete	nirK  norB nosZ
Rothia 	Denitrification-partial	nirK  norB
Rubrivivax 	Denitrification-complete	nirS norB  nosZ
Rubrobacter 	Denitrification 	Denitrification
Ruegeria 	Denitrification-complete	nirS norB  nosZ
Ruminiclostridium 1 	Cellulolytic 	Cellulolytic
Ruminococcus 	Cellulolytic 	Cellulolytic
Rummeliibacillus 	non-N 	non-N
Runella 	 	nosZ
Saccharibacter 	non-N 	non-N
Saccharomonospora 	Denitrification-nirK	nirK
Saccharophagus 	non-N 	non-N
Saccharospirillum 	Denitrification 	Denitrification
Salinibacter 	 	nosZ
Salinibacterium 	non-N 	non-N
Salinisphaera 	Denitrification-complete	nirK  norB  nosZ
Sanguibacter 	Denitrification-nirK	nirK
Scardovia 	Denitrification-nirK	nirK
Sediminibacterium 	non-N 	non-N
Serinicoccus 	Denitrification-nirK	nirK
Shd-14 	Cellulolytic 	Cellulolytic
SHD-14 	Cellulolytic 	Cellulolytic
Shewanella 	Denitrification-complete	nirK  norB nosZ
Sideroxydans 	N fixation 	N fixation
Silicibacter 	Denitrification-complete	nirK nirS norB nosZ
Siluania 	non-N 	non-N
Simkania 	non-N 	non-N
Simonsiella 	Denitrification-complete	nirK  norB  nosZ
Simplicispira 	Denitrification 	Denitrification
Sinorhizobium 	Denitrification-complete	nirK  norB nosZ
SM1A02 	Denitrification 	Denitrification
Smb53 	Cellulolytic 	Cellulolytic
SMB53 	Cellulolytic 	Cellulolytic
Smithella 	Propiote oxidation-syntrophy 	Propiote oxidation-syntrophy
Solibacillus 	non-N 	non-N
Solibacter 	 	norB
Solitalea 	Denitrification 	Denitrification
Sphaerobacter 	non-N 	non-N
Sphingobacteriia 	 	N_cycle  S_cycle      aerobic
Sphingobacterium 	non-N 	non-N
Sphingobium 	non-N 	non-N
Sphingomodales 	 	N_cycle  S_cycle     C1_ox  aerobic
Sphingomos 	non-N 	non-N
Sphingopyxis 	 	N_cycle  S_cycle     C1_ox  aerobic
Sphingorhabdus 	non-N 	non-N
Spirobacillus 	non-N 	non-N
Spirochaeta 	Cellulolytic 	Cellulolytic
Spirochaeta 2 	Cellulolytic 	Cellulolytic
Spirochaetes 	 	C_fix  N_fix  N_cycle  S_cycle   H2_ox  H2_prod  C1_ox  aerobic
Sporobacter 	Methanotroph 	Methanotroph
Staphylococcus 	non-N 	non-N
Stappia 	Denitrification-complete	nirS norB nosZ
Starkeya 	Denitrification-partial	nirK  norB
Stenotrophomos 	non-N 	non-N
Steroidobacter 	Denitrification+ 	Denitrification+
Sterolibacterium 	Denitrification 	Denitrification
Streptococcus 	non-N 	non-N
Streptomyces 	non-N 	non-N
Streptosporangium 	Denitrification-nirK	nirK
Subgroup 10 	varied 	varied
Sulfobacillus 	Denitrification-nirK	nirK
Sulfolobus 	 	norB
Sulfuricella 	Denitrification-complete	nirS norB  nosZ
Sulfuricurvum 	Denitrification 	Denitrification
Sulfurimos 	Denitrification 	Denitrification
Sulfurisoma 	Denitrification 	Denitrification
Sulfuritalea 	Denitrification 	Denitrification
Sulfurospirillum 	Sulfur reduction 	Sulfur reduction
Sulfurovum 	Denitrification-complete	nirS norB  nosZ
Sunxiuqinia 	non-N 	non-N
Sutterella 	Denitrification 	Denitrification
SWB02 	varied 	varied
Symbiobacterium 	Denitrification-nirK	nirK
Synechocystis 	 	norB
Syntrophobacter 	Methanotroph 	Methanotroph
Syntrophobacterales 	 	C_fix    S_cycle     C1_ox  aerobic
Syntrophorhabdus 	Denitrification+ 	Denitrification+
Syntrophus 	Methanotroph 	Methanotroph
Taylorella 	Denitrification-nirK	nirK
Telmatospirillum 	N fixation-methanogen 	N fixation-methanogen
Tenericutes 	 	H2_prod   aerobic
Terrimos 	non-N 	non-N
Thalassospira 	Denitrification-complete	nirS norB  nosZ
Thauera 	Denitrification-complete	nirS norB nosZ
Thaumarchaeota 	 	C_fix    S_cycle  Fe_Cycle   H2_prod  C1_ox  aerobic
Thermaerobacter 	Denitrification-nirK	nirK
Thermoaerobaculaceae_family_Subgroup 10 	varied 	varied
Thermobaculum 	Denitrification-nirK	nirK
Thermobifida 	Denitrification-nirK	nirK
Thermobispora 	Denitrification-nirK	nirK
Thermodesulfovibrio 	 	C_fix   N_cycle  S_cycle   H2_ox  H2_prod  C1_ox  aerobic
Thermomicrobium 	 	nosZ
Thermomos 	non-N 	non-N
Thermus 	Denitrification-partial	nirK nirS norB
Thioalkalivibrio 	Denitrification-complete	nirK  norB  nosZ
Thiobacillus 	Sulfur oxidation 	Sulfur oxidation
Thiobacter 	non-N 	non-N
Thiocapsa 	 	norB  nosZ
Thiohalophilus 	Denitrification 	Denitrification
Thiothrix 	Denitrification 	Denitrification
Tolumos 	non-N 	non-N
Treponema 	non-N 	non-N
Trichococcus 	Denitrification 	Denitrification
Trichophyton 	Denitrification-partial	nirK  norB
tronomos 	Denitrification-nirK	nirK
Turneriella 	Denitrification-nirK	nirK
Uncinocarpus 	Denitrification-partial	nirK  norB
uncultured 	uncultured_bacteria 	uncultured_bacteria
uncultured archaeon 	uncultured_archaea 	uncultured_archaea
uncultured bacterium 	uncultured_bacteria 	uncultured_bacteria
uncultured Bacteroidetes bacterium 	non-N 	non-N
uncultured Candidatus Omnitrophus 	Magnetatactic+ 	Magnetatactic+
uncultured Chlorobi bacterium 	Sulfur oxidation 	Sulfur oxidation
uncultured euryarchaeote 	uncultured_eukaryote 	uncultured_eukaryote
uncultured Microgenomates group bacterium 	uncultured_bacteria 	uncultured_bacteria
uncultured organism 	uncultured 	uncultured
uncultured Parcubacteria group bacterium 	CPR-OD1 	CPR-OD1
uncultured soil bacterium 	uncultured_bacteria 	uncultured_bacteria
Undibacterium 	non-N 	non-N
varied 	varied 	varied
Variovorax 	non-N 	non-N
Veillonella 	non-N 	non-N
Verrucomicrobia 	 	N_cycle  S_cycle    H2_prod   aerobic
Verrucomicrobium 	non-N 	non-N
Vibrio 	 	nosZ
Virgibacillus 	Denitrification-nirK	nirK
WCHB1-05 	Cellulolytic 	Cellulolytic
Wchb1-05_f__Aerolineacaea 	varied 	varied
Wolinella 	 	nosZ
Xanthomodales 	 	N_cycle  S_cycle     C1_ox  aerobic
Xylanimos 	Denitrification-nirK	nirK
Zobellia 	 	norB  nosZ
Zoogloea 	non-N 	non-N
